$$$$$$$$$^^$$$$$$$$$
$$$$$$$$____$$$$$$$$
$$$$$$________$$$$$$
$$$$____________$$$$
$$________________$$
<__________________>
$$$______________$$$
$__________________$
$_$______________$_$
$_$$____________$$_$
$_$___$______$___$_$
$_$_$$$______$$$_$_$
<__________________>
$$$$$__________$$$$$
$__________________$
$__________________$
$$$$$$$$$vv$$$$$$$$$
