$$^^^^^^^^^^^$$
$$$$$o$o$o$$$$$
$$$$$o$o$o$$$$$
$$ooooooooooo$$
$$o$$$ooo$$$o$$
<oo$$$ooo$$$oo>
$$ooooooooooo$$
<oo$$o###o$$oo>
$$oooo###oooo$$
$oo$$o###o$$oo$
$o$$$o###o$$$o$
$ooooooooooooo$
$$$$$o$o$o$$$$$
$$vvvvvvvvvvv$$