$$^^^^^^^^^^^$$
$$$$$o$o$o$$$$$
$$$$$o$o$o$$$$$
$$oooo$o$oooo$$
$$o$$$ooo$$$o$$
<oo$$$ooo$$$oo>
$$oooo###oooo$$
<oo$$o###o$$oo>
$ooooo###ooooo$
$o$$$o###o$$$o$
$o$$$o###o$$$o$
$ooooooooooooo$
$$$$$o$o$o$$$$$
$$vvvvvvvvvvv$$